||||||||||||||||
|000000|||00||00
|00|0|||0000000|
|0||00000|||0|||
|0|||||||0||0|||
|0000|||00||00||
|||000000||||0||
|000|||0000000||
|0||||||00||0|||
|0||||||||||||||
